Uber|uber.com,ubereats.com,uberinternal.com|
Apple|apple.com,icloud.com|.*phobos.*
Github|github.com,githubapp.com,githubusercontent.com|
Paypal|paypal.com,xoom.com|
Tesla|solarcity.com,tesla.cn,tesla.com,tesla.services,teslainsuranceservices.com,teslamotors.com|
Facebook|facebook.com,fb.com,instagram.com,oculus.com,internalfb.com,thefacebook.com,workplace.com,accountkit.com,fb.me,freebasics.com,whatsapp.net,messenger.com,internet.org|
Bugcrowd|bugcrowd.com|
Hackerone|hackerone.com,hacker101.com,hackerone.net,hackerone-ext-content.com|
Snapchat|snapchat.com,sc-corp.net|
Twitter|twitter.com,vine.co,periscope.tv,twimg.com,pscp.tv,twttr.com|twitter.com/.+/status/[0-9]+,syndication,*.ts$,.*video.pscp.tv.*,.*video.periscope.tv.*,.*oembed.*,.*www.pscp.tv.*,.*/w/.*,.*m3u8$
Airbnb|airbnb.com,byairbnb.com,airbnb-aws.com,muscache.com,luxuryretreats.com,hoteltonight-test.com,atairbnb.com,withairbnb.com,airbnbcitizen.com|
Netflix|netflix.com,nflxext.com,nflximg.net,nflxso.net,nflxvideo.net|
Atlassian|atlassian.com,atlassian.net,atlastunnel.com|
Palantir|palantir.com,palantir.tech,palantir.build,palantircloud.com,palantircloud.co.uk,palantirfoundry.com,palantirfoundry.co.uk,palantirfoundry.de,palantirfoundry.fr,palantirfoundry.com.au,palantirgov.com,foundrygov.com|
AT&T|att.com|
Dell|dell.com,delltechnologies.com|
Acronis|acronis.com,5nine.com,devicelock.com,acronis.work|
Adobe|acrobat.com,adobe.io,adobeaemcloud.com,adobecqms.net,bizible.com,marketo.com,mixamo.com,omniture.com,phonegap.com,tubemogul.com,typekit.com|
IBM|ibm.com|
Sony|sony.com|
Playstation|playstation.com,playstation.net,sonyentertainmentnetwork.com|
Spotify|spotify.com,spotify.net|
Zomato|zomato.com,zdev.net,zomans.com,hyperpure.com,runnr.in|
EpicGames|epicgames.com,rocketleague.com,psynet.gg,unrealtournament.com,unrealengine.com,fortnite.com,epicgames.dev,3lateral.com,cubicmotion.com,oncatapult.com,fallguys.com,mediatonic.co.uk,artstation.com,easy.ac,sketchfab.com,quixel.com,superawesome.tv,superawesome.com,popjam.com,rukkaz.com,jellychat.com|
Valve|valvesoftware.com,steampowered.com,steamgames.com|
Xiaomi|mi.com,xiaomi.com,miui.com,xiaomiyoupin.com,miwifi.com|
Roblox|roblox.com,rbx.com,guilded.gg,ra.roblox.com|
Grab|myteksi.com,myteksi.net,grab.com,grabpay.com,grabtaxi.com,grab.co|
Coinbase|cbhq.net,coinbase.com|
TikTok|tiktok.com,tiktokv.com|
SoundCloud|soundcloud.com,soundcloud.org|
Rakuten|rakuten.com|
Yahoo|yahoo.com|
HubSpot|hubapi.com,hubspot.com,hubspot.net,hubspotemail.net|
Binance|binance.com,bnbchain.org|
Acorns-Grow|acorns.com|
AMEX-Global-Business-Travel|amexgbt.com,amexglobalbusinesstravel.com,banks-sadler.com,gbtad.com,gbtexternal.com,gbtspain.com,hrgnorthamerica.com,hrgworldwide.com,kds.com,lawyerstravel.com,meetingsexpreess.com,meetingsexpress.com,meetingssource.com,miclientool.com,mieventool.com,miwebtool.com,mykds.com,ovationtravel.com,sourcingcenteramexgbt.com,supplierstool.com,uathrg-isuite.com,uathrgisuite.com,GBTNTA.com,neo1.com|
Arrow-Electronics|aepetsche.com,arrow.cn,arrow.com,aspencore.com,chip1stop.com,eetimes.com,einfochips.com,elektroda.pl,immixgroup.com,powerandsignal.com,richardsonrfpd.com,siliconexpert.com,transim.com,verical.com,xsp.arrow.com|
Aruba-Networks|arubanetworks.com|
Asana|app.asana.com,asana.biz,asana.plus|
Arrow-Electronics|aepetsche.com,arrow.cn,arrow.com,aspencore.com,chip1stop.com,eetimes.com,einfochips.com,elektroda.pl,immixgroup.com,powerandsignal.com,richardsonrfpd.com,siliconexpert.com,transim.com,verical.com,xsp.arrow.com|
Aruba-Networks|arubanetworks.com|
Bitdefender|bitdefender.com,bitdefender.net|
BitDiscovery|bitdiscovery.com|
Bureau-of-Land-Management|abandonedmines.gov,blm.gov,nifc.gov|
Cash-App|cash.app,cashstaging.app,joinverse.com,verse.events,verse.me|
Cengage|cengage.com|
Cisco-Meraki|ikarem.io,meraki.com,network-auth.com|
Coca-Cola-Company|appletiser.com,barqs.com,blueskysoda.com,coca-cola-deutschland.de,coca-cola-france.fr,coca-cola-oesterreich.at,coca-cola.com,coca-colaarabia.com,coca-colacompany.com,coca-colaentuhogar.com,coca-colaitalia.it,coca-colamaroc.ma,coca-colaukraine.com,cocacola-kos.com,cocacolabelgium.be,cocacolaespana.es,cocacolanederland.nl,cocacolaportugal.pt,cocacolastore.fr,cokestore.com,cokeurl.com,dasani.com,dietcoke.com,drinkaha.com,drinkmoxie.com,fresca.com,fuzebev.com,hansens.com,hi-c.com,honesttea.com,ko.com,melloyello.com,pibb-xtra.com,powerade.com,sprite.com,surge.com,testko.com,topochico.com,vebatcoke.com,vitaminwater.com|
CoinDCX|coindcx.com,dcxstage.com|
Comcast-Xfinity|comcast.com,sys.comcast.net,xfinity.com|
Credit-Karma|creditkarma.com|
Indeed|indeed.com,indeed.tech|
SEEK|aips-internal.com,certsy.com,certsynonprod.com,jobapi.io,jobapi.net,outfra.xyz,seek.com,seek.com.au,skinfra.xyz,sol-data.com|
Sophos|astaro.com,cyberoam.com,hitmanpro.com,reflexion.net,sophos.com|
SoundCloud|repostnetwork.com,s-cloud.net,soundcloud.com,soundcloud.org|
Statuspage|statuspage.io|
Takeaway.com|10bis.co.il,bistro.sk,citymeal.com,eat.ch,just-eat.dk,just-eat.fr,just-eat.no,justeattakeaway.com,lieferando.at,lieferando.de,scoober.com,takeaway.com,thuisbezorgd.nl,yourdelivery.de|
Azena|azena.com|
BCC|bcc.nl|
BMC|bmc.nl|
CM|cm.com|
CanadaPost-Purolator|canadapost-postescanada.ca,postescanada-canadapost.ca,purolator.com|
DPG-Media|dpgmedia.be,dpgmedia.nl|
Darwinex|machina.markets|
De-Morgen|demorgen.be|
EURid|das.eu,dns.eu,eurid.eu,nic.eu,registry.eu,whois.eu,yadifa.eu|
Gulp|gulp.ch,gulp.de|
